4 5 4984 2739 76 6043 4297 
2 7 4297 6021 5997 5983 3533 3361 1863 
4 9 4297 4931 200 3432 4010 2945 4039 6058 1100 
4 6 4297 6092 3884 6143 6172 1781 
4 3 4620 1781 4774 
4 16 6980 5451 4431 296 6926 3186 5031 726 2843 4476 6898 437 3494 4930 2147 4006 
5 6 4006 6800 6760 6750 708 4628 
5 12 4628 2483 2180 3114 6720 2318 549 6708 573 4447 1437 6610 
4 3 5094 2365 3125 
3 5 3125 2375 2211 6276 6252 
4 4 6252 4061 6247 4710 
4 4 4710 2092 2694 6235 
4 9 6235 4685 4427 4704 5437 1757 6159 6130 557 
4 5 5853 5827 5792 5778 2768 
3 6 5853 5858 3732 1440 5872 3861 
3 7 1088 6022 2169 1888 6024 3292 4468 
1 2 4468 1100 
3 4 7233 3387 7241 4991 
3 6 7230 4991 7284 1338 7318 7323 
2 5 7230 7238 4347 1143 4994 
2 6 4994 3629 7250 676 4162 7245 
4 5 557 1404 6078 5226 6022 
2 5 1863 5893 3298 4572 2119 
3 5 5179 4879 1472 6038 2897 
4 7 5179 1312 84 5096 1641 3065 4984 
3 9 84 1943 3458 1661 2895 447 1590 1304 4620 
2 7 4984 6004 5989 1242 4211 1234 2119 
2 7 2897 1968 3469 2533 578 4295 6152 
3 5 2897 5257 5984 5310 1458 
3 9 5984 3031 3752 4564 4651 4544 6047 436 6090 
2 9 1590 3657 2252 4341 3618 6292 311 5162 1831 
2 3 1831 1808 3026 
2 8 1312 3615 5242 3874 6226 5107 6300 311 
2 6 1458 759 4148 149 906 5783 
2 8 5179 2951 3098 5991 5962 5938 4667 5919 
1 4 5919 2360 5923 4211 
2 4 5938 5911 5895 4148 
3 6 2119 2756 5822 3013 2639 4330 
2 8 5783 2144 3937 5705 961 2417 502 5648 
2 10 502 3667 1370 4426 5634 2559 5616 636 5080 3300 
1 4 3300 2724 2041 4434 
2 5 4434 2447 2261 2294 306 
1 8 2261 2393 2592 3207 1294 3917 5625 3631 
3 6 306 5438 2121 4055 2020 3468 
3 6 4055 5660 4500 1350 3279 4824 
3 10 4330 5762 2470 5713 2953 3270 1918 2777 5400 306 
1 4 5762 934 514 4742 
2 9 3468 5712 767 1236 1719 5826 5857 1869 5886 
2 3 5886 1851 2466 
1 6 4742 3687 2774 4896 4612 1719 
4 6 4774 4449 3202 6324 719 6348 
1 6 573 5510 1807 2516 4869 925 
1 5 925 2544 356 6756 1124 
1 6 1124 3680 6711 2416 3708 6677 
1 4 6677 4237 6614 5485 
1 5 5485 1563 997 5323 2952 
1 4 392 4923 5530 1203 
1 6 5485 6564 4906 640 6527 4560 
1 7 640 4743 1905 4942 6433 4072 1831 
1 6 640 1290 2176 709 1741 2031 
1 3 2031 2868 6348 
5 4 4323 2311 2402 6851 
5 8 6851 5198 5301 5424 6860 6872 6899 3972 
3 8 5094 3538 6349 6326 2596 6280 1190 2769 
2 4 2769 4462 1425 2540 
2 5 2540 5524 3552 6113 1391 
2 9 1391 1892 6064 6044 6015 3816 3543 4584 1452 
3 10 1452 1085 3446 965 5780 5106 5768 3004 5069 2768 
2 5 3004 1725 4048 2575 5655 
1 8 2575 3467 4466 67 860 4748 704 4657 
2 6 4657 2826 2464 4047 3940 5658 
2 7 2464 5763 3392 5806 4959 2070 5040 
2 6 5040 4874 5517 1774 6062 4753 
3 7 4753 5287 1611 4977 2840 6240 1190 
2 6 4824 3043 5661 5673 2383 5658 
1 6 3125 2892 6400 1406 5439 6387 
3 9 5094 6419 3414 4621 4103 6528 943 495 5053 
3 5 5053 6602 3230 6634 5046 
3 8 5046 6694 4307 4227 3576 4311 1840 2147 
2 8 4476 6874 2373 6825 4208 2983 6771 3517 
2 18 3517 2066 6697 2888 848 6642 3923 591 1910 2370 6538 2436 6499 6481 6469 3335 2202 5094 
2 13 6481 3658 1819 6460 4314 1146 4266 6373 3949 650 5365 5549 3985 
1 11 4704 6251 3919 6305 2021 2738 6386 3091 6431 1209 1203 
1 5 5046 825 6639 6626 3923 
1 16 495 4796 3594 2700 3260 4591 58 869 4066 3203 292 4614 6653 6672 1604 6720 
3 11 1124 3005 3460 6844 4803 3428 6916 2250 2315 6960 6977 
1 6 6977 2539 7055 3219 1072 614 
3 6 4803 3252 3868 6869 6876 6885 
1 7 3868 6907 3637 1418 6968 3144 7018 
1 8 7018 7046 3992 4672 4717 1364 4988 5041 
3 8 6977 3017 1219 4285 7041 7061 3757 7081 
3 5 7081 5497 3622 4212 3290 
3 8 3622 2550 5434 7089 2529 7042 3837 6996 
3 5 6996 2615 3023 7059 5038 
2 5 6996 4086 594 6935 6913 
3 10 5038 7090 3991 3769 1293 7082 7093 3284 3226 7111 
3 6 7111 7138 3357 4678 7216 7245 
3 6 7111 7107 7094 4172 7071 620 
3 6 620 7067 681 2878 7003 6980 
3 7 620 4392 7139 826 4752 1516 7230 
1 4 7245 7248 2594 7305 
3 7 7245 7216 1049 7227 5309 1361 7286 
3 7 7286 1868 888 4969 1226 7226 7201 
3 5 7201 2935 2511 3536 5038 
4 6 5428 2967 6927 1797 1995 6851 
3 8 5428 6962 6972 3258 7015 1916 3396 3824 
2 13 3972 4594 6875 6863 3910 4229 4814 6880 6884 1931 3426 6862 4677 
3 7 3972 5189 4260 1251 6955 1973 7015 
2 11 3824 7051 4859 7020 4862 1228 1511 5380 7065 3928 1455 
2 7 5480 6992 3651 740 97 2083 6896 
2 5 6775 4828 1427 3969 6896 
2 6 6775 4823 4096 1877 6651 6638 
2 3 2709 663 1873 
2 5 2709 6568 2349 2578 6530 
2 7 1873 5295 4822 371 1042 3553 6374 
3 6 6374 2956 3324 1575 6253 3810 
3 6 3324 6313 6289 675 5055 73 
2 4 73 2074 605 4669 
3 10 5090 2714 6188 4429 355 6150 861 1854 4038 179 
3 7 5090 6237 3348 4195 3416 6204 6215 
3 5 6215 2798 6151 1277 5535 
3 9 1277 1627 1928 6119 4535 1297 3639 4958 2580 
2 5 5190 237 6334 1379 4958 
3 10 2580 4180 485 3931 526 6473 1635 3668 3034 4627 
3 6 4627 4471 1599 3621 6530 2175 
1 15 4627 1321 6572 631 1762 2099 2106 5432 363 6864 744 3227 2215 6896 4677 
2 5 5535 1904 5338 1445 2258 
2 6 2258 1108 1989 4246 3666 3853 
2 6 675 6261 628 4146 3291 1325 
2 7 179 2799 951 6100 4127 2103 1325 
2 6 2103 6065 3748 3475 3934 2367 
3 7 2768 4383 4711 5735 4996 1274 3254 
3 9 3861 2152 1963 5875 2908 2963 4215 655 5824 
3 6 3254 5307 5790 4281 5838 2908 
1 9 4753 3156 4976 5361 6163 2310 2600 6227 6252 
2 14 6916 6909 1215 4416 388 1275 3229 4663 6832 4665 5116 583 3954 6720 
1 7 925 4450 6625 6601 6576 3183 392 
1 5 5530 6456 3827 4372 2031 
3 4 4323 1365 5003 1926 
2 4 4359 2081 7402 7391 
2 9 7391 1678 5171 962 2012 3855 327 4169 7323 
2 8 4359 7417 2848 2415 7467 2313 2384 7522 
3 15 7323 3405 4069 1468 7381 3983 4142 4470 3993 7406 3477 7410 1922 4574 4126 
3 16 4142 2626 7441 163 5534 2323 4401 2010 1872 7536 3431 7553 4161 3713 4618 4423 
2 9 7522 7515 2753 5462 7538 2328 1169 7550 4161 
4 7 1872 3071 2699 1601 3587 7529 7525 
2 8 7525 2085 4001 7567 995 2037 7608 2647 
4 18 7525 7519 4505 7507 1112 7499 5111 2860 7487 3038 2413 2143 7452 1113 4174 5216 702 2172 
3 6 3587 7556 1235 5505 2800 489 
3 17 489 2649 5143 4915 660 4782 5213 7631 1935 7641 4985 245 7646 2253 7645 915 1248 
2 7 4423 7560 3580 5399 7575 1332 4849 
2 8 4849 7596 4463 7616 7623 7630 7640 1248 
2 11 7623 4800 2558 7633 4898 5229 3117 7652 7660 5391 491 
3 8 1248 3753 4997 5321 512 5157 5151 7678 
3 5 7678 7689 3951 4735 7695 
3 12 2172 7461 3406 4583 7504 3463 7530 3555 7559 4644 7587 7600 
3 11 1452 343 5913 3568 5952 673 4098 2786 5898 5877 3732 
3 8 5824 4075 4947 126 5729 3846 5740 3853 
3 10 6348 6321 6301 6257 1422 1866 2016 3410 2460 4704 
1 6 1422 2670 1565 3105 2201 2945 
2 7 6090 2970 6096 2557 1620 4337 4097 
2 6 4337 4699 1685 4421 1622 5052 
2 9 1622 5864 3130 91 5793 2129 5782 5760 1288 
2 16 4295 116 6216 6233 6260 3143 6318 6347 3162 4338 6407 3609 6449 1628 6480 6470 
2 5 6470 6446 6401 4596 3026 
1 4 6260 6246 3197 1071 
1 7 1288 5711 5696 5697 1749 867 5246 
1 5 5246 2335 5752 5765 2144 
1 3 5517 3282 5957 
2 6 2367 3462 5990 782 5518 3861 
2 11 4429 2007 6079 5166 4262 5927 2795 5908 1318 1359 5824 
2 12 1926 1979 6737 4519 2247 4558 4245 6595 1756 3830 3762 4669 
1 5 605 2002 6547 2285 2929 
1 6 1452 2509 4866 5876 2628 4506 
1 7 4506 3800 4593 5807 3430 2243 5763 
1 4 1391 5330 2986 1880 
1 6 1880 4099 6249 3217 4794 3985 
1 7 7461 990 3310 3263 2428 5370 2251 
1 7 3846 5159 4210 1544 1804 109 83 
2 13 3824 2752 3233 11 5265 7218 5024 566 7302 460 7344 7371 4126 
2 18 7302 2027 4111 2707 7322 3370 173 7310 4101 2810 5372 1500 7283 3901 3889 1707 3287 7173 
2 8 5480 1455 7063 7079 3511 7097 7130 4404 
1 8 7173 1908 4404 7119 3869 5344 7039 5440 
1 3 4726 7356 902 
1 2 1365 616 
1 5 6760 4652 4502 4867 5512 
1 7 5361 3313 6122 3886 6072 3518 2968 
1 3 5806 183 2727 
1 8 2727 684 4852 5508 4503 4349 2193 4824 
1 3 4824 2019 3631 
1 5 4246 1770 5880 1012 4262 
2 2 2540 6209 
1 8 6387 4812 1832 6439 4312 5137 6502 4591 
1 4 6407 2634 2729 3180 
1 6 3180 2380 3833 2471 4539 5107 
1 8 3013 938 5761 2288 2361 3665 4084 5705 
1 8 3752 5900 5874 846 1745 5803 4588 2335 
1 7 4097 1120 6074 3636 6071 1258 565 
1 4 5705 5685 3638 4597 
1 7 3622 7047 4438 6991 581 6939 2864 
1 10 4105 5237 6520 6496 6475 2122 412 3528 1982 6433 
1 6 1544 2737 4746 5643 644 1161 
5 6 5428 5362 6967 3773 1600 9062 
5 4 9062 1778 4700 6980 
3 21 5523 4617 7233 3575 7180 5453 7101 2025 430 7008 9062 6966 792 3515 358 4602 564 6802 6785 616 4323 
1 2 6184 3410 
2 6 6058 2547 3980 1724 2879 6184 
1 3 1781 3372 1625 
1 2 4336 5096 
1 2 175 5761 
1 7 767 3248 1446 1348 277 5662 2777 
1 4 2305 5662 277 306 
1 2 5070 1350 
1 10 5908 1705 1886 4167 1783 5995 5999 6018 3187 3748 
1 4 1783 4350 6055 951 
1 10 614 7117 4316 4351 2239 7196 2989 4971 713 5041 
1 2 479 392 
1 6 4906 6561 3058 1713 1064 479 
1 3 3827 6472 479 
2 16 3463 7521 4132 7537 1665 3725 7547 7542 2026 1025 1722 3381 1619 1001 4016 7608 
1 8 7608 3030 7619 3661 3944 2224 4369 489 
1 10 2224 7625 3444 7636 3766 1009 7668 3302 5149 368 
1 10 368 2520 4089 2140 2265 7671 4340 7664 2491 245 
2 17 3753 5238 5406 360 7693 3056 7705 2011 2556 5092 778 2396 7706 7710 3391 7702 4735 
1 18 4735 2903 5443 932 7715 3742 3573 7743 7737 7741 3913 3839 7759 1119 5539 1833 2320 7756 
1 6 2010 5212 3789 7511 4516 1169 
1 9 485 4063 963 6524 5060 2035 2976 4817 1374 
1 8 1374 2930 1328 6873 576 4292 3095 6864 
1 6 576 653 249 3654 3759 5440 
1 15 653 3796 1177 5308 7072 1803 5366 165 3450 545 1129 7297 2156 7334 7338 
1 11 7338 2690 7369 1747 3674 5188 7399 287 4056 5064 2251 
1 3 4862 6983 6953 
1 6 6953 2338 3179 1264 6895 6875 
1 6 2035 1990 4872 269 5411 6572 
1 6 6572 3132 1091 6579 6587 2349 
2 13 2709 2512 5163 6638 1736 2136 1810 6650 3376 3617 688 6646 4245 
1 3 485 3439 237 
1 6 2143 3616 3166 813 2204 1922 
3 3 3570 162 7201 
1 6 3091 3519 6393 6370 4635 6321 
1 4 6393 1618 952 3827 
1 2 392 6558 
1 10 4449 6297 192 4811 3962 6322 45 6351 2214 4072 
1 16 4560 6573 1574 6621 3703 1265 2571 5128 1263 4889 6514 6487 5345 4595 6557 4105 
1 4 5512 5441 3400 5053 
1 7 5213 1289 4875 7656 7659 7661 7668 
1 8 7499 772 7505 1462 3561 4870 589 1722 
1 10 7511 7501 5350 5155 2535 2588 5392 7408 3352 7391 
1 6 2415 7457 3489 1740 7481 5350 
1 4 2512 6577 4833 2929 
3 9 2175 6507 4017 6454 1257 4522 6399 6382 6374 
1 6 6215 4880 4402 6245 3334 5190 
1 8 1112 7496 7477 3702 2267 2718 2518 2626 
1 10 163 2052 1344 7443 7437 1667 5405 2054 3409 2535 
1 5 3855 1962 7407 5532 1667 
1 6 1088 5994 5974 14 5905 1851 
1 7 1869 5878 4280 5941 2411 5993 4468 
1 7 2879 6153 1376 4507 3259 2779 2169 
1 5 3259 6088 4469 6056 2547 
1 2 6184 897 
1 7 897 6201 2670 4125 6179 3720 1625 
1 10 5993 1240 5969 2276 4838 5889 1614 604 470 4742 
1 5 1614 5871 2039 4064 1863 
1 6 4426 5665 758 832 3142 2470 
1 2 201 2724 
3 3 288 5767 5780 
1 3 6217 4900 1880 
1 7 5529 6936 2586 1305 7009 2548 1228 
1 2 3426 5529 
2 13 2027 7264 4304 5214 7207 7192 2359 2702 4009 4171 3595 5520 4862 
1 7 2702 4454 7166 3946 2429 7118 7099 
1 3 2586 2205 6992 
1 8 4039 6049 3311 3193 4309 133 4706 3533 
3 4 7323 1296 7314 5523 
2 3 4363 2866 1338 
2 3 3545 3188 7318 
1 3 3545 7354 2012 
1 3 4363 7316 3545 
1 18 6775 1718 6739 600 2861 6763 2689 1699 6773 3006 6768 6757 4425 6748 6749 5454 6731 4519 
3 3 3324 3540 190 
1 8 1807 6732 3737 2693 6799 4989 586 3005 
1 4 2693 4922 2030 925 
1 6 925 4531 2290 3653 3177 2952 
1 2 1713 2952 
1 5 3680 6770 4234 6795 1342 
1 8 4817 252 3741 2099 3670 3844 1018 4823 
1 4 1091 6600 219 3670 
1 4 219 6647 3481 6651 
1 6 4266 382 1865 4515 5156 6349 
1 5 4099 6232 1491 4720 6209 
1 6 6373 3933 5061 2093 448 1491 
1 7 1190 6248 6225 4286 5001 6178 5361 
1 5 2968 6013 4176 1303 4874 
1 14 1391 6091 5180 6041 2291 6005 1492 1919 3152 5029 3022 5848 4282 5807 
1 5 673 3579 4884 5423 6015 
1 7 2986 6138 734 6114 6086 1937 4884 
1 19 616 6752 1689 6717 4582 6695 6685 2572 1173 1894 6617 6598 647 5436 3642 5300 3829 1805 6460 
1 4 3152 3605 5946 5957 
1 8 3552 3878 3986 5103 3101 6040 1165 1774 
1 2 1165 3282 
1 14 5655 3801 1003 4761 2940 559 1105 3557 2127 1899 1426 2336 5668 5658 
1 3 860 5669 1426 
1 13 628 4777 3427 2618 4901 5101 3403 2024 5531 4113 6081 4155 2367 
1 9 3403 4993 6205 1798 4771 6223 6218 3015 6217 
1 4 4098 5253 6026 5387 
1 7 6086 5447 5515 5387 6068 6069 4155 
1 3 6487 3070 1982 
1 5 400 5132 756 2343 5179 
1 6 400 3057 3686 6270 3212 3180 
1 6 6547 4456 2203 1677 6611 3617 
1 3 2203 4406 1756 
1 4 688 4759 2040 4425 
1 5 1810 2388 6709 1558 2689 
1 4 2929 1479 6599 1810 
1 3 6599 2669 1677 
1 3 1736 6609 1479 
1 5 1736 1429 6710 6723 2861 
1 4 1429 6692 1850 6709 
1 8 237 6389 4684 6395 4213 1920 3344 4627 
1 3 526 2044 6389 
1 3 2044 2713 1920 
1 4 1635 3744 3821 6524 
1 3 3821 9 4872 
1 4 252 6676 1885 5411 
1 2 6676 631 
1 4 6647 1843 6592 2709 
1 3 6647 6686 1018 
1 9 4627 645 2732 828 6423 3332 3988 4493 6507 
1 2 3988 994 
1 3 2732 2067 6513 
1 4 3621 6512 2067 3988 
1 2 6513 1599 
1 2 994 6530 
1 5 5535 852 4847 444 2007 
1 6 1108 4377 151 375 821 6079 
1 8 5512 6662 3879 6649 6637 4950 4110 3114 
1 6 3879 6616 1245 4271 6570 3594 
1 5 3923 2846 4386 6589 5436 
1 12 4212 2637 7125 1592 4661 7159 2816 5115 7148 874 7157 614 
1 9 5038 1586 7110 2760 7149 7133 5011 2166 7089 
1 6 6913 2101 984 4623 3401 2864 
1 9 2864 1788 3614 4908 2183 6969 210 6987 3017 
3 4 7011 2998 7025 1293 
3 5 7011 5417 7002 2403 2615 
1 14 3925 3787 3321 4580 5519 3660 2776 6039 2086 5176 2927 1566 1045 2418 
1 2 3925 4710 
1 2 3925 2092 
1 13 6552 1490 3167 3914 6434 6409 1063 6371 6353 3929 3246 6259 4710 
1 2 2092 6259 
1 3 3167 6534 3266 
1 3 4284 2717 6431 
1 5 6558 3646 5483 754 1203 
1 5 3646 1323 3854 2200 6601 
1 3 569 2734 6163 
